11111111111111111111111111
1C0000000001S00000000000E1
11111111110001111111111111
1C000000001100000011111111
111111111000011110000000C1
1C000000011100000111111111
111111110000011100000000C1
1C000000111100001111111111
111111100000011000000000C1
11111111111100011111111111
1P0000000000W10000000000C1
11111111111111111111111111