1111111111111
10010000000C1
1E00011111W01
1PWC11E000001
1111111111111
